R 1000 234
       
NO textures/greystone.xpm
SO textures/eagle.xpm
WE textures/purplestone.xpm
EA textures/wood.xpm
S textures/pillar.xpm

F 220,4,0
C 225,30,0

       
      
       
1111111111111111
102000000000011
100000W00000001
1000000000000001
1111111111111111
1111111111111111
100020000000011
1000000001100001
100000020111111
1111111111111111

