R 900 700
       
NO textures/greystone.xpm
SO textures/eagle.xpm
WE textures/purplestone.xpm
EA textures/wood.xpm
S textures/pillar.xpm

C 0,0,0
F 255,255,255

       
      
1111111111111111
100020000E000001
1000201010000011
1000201011000001
1000201001000001
1000200000000001
1111111111111111