R 900 700
       
NO textures/greystone.xpm
SO textures/eagle.xpm
WE textures/purplestone.xpm
EA textures/wood.xpm
S textures/pillar.xpm

C 0,0,0
F 255,255,255

      
      
1111111111111111
10202200010002S1
1011111100000021
1010001000000121
1010111211010101
1002000000010001
1111111111111111