R 900 700
       
NO textures/greystone.xpm
SO textures/eagle.xpm
WE textures/purplestone.xpm
EA textures/wood.xpm
S textures/pillar.xpm

C 0,0,0
F 255,255,255

      
      
1111111111111111
1000000000000001
1000022222200001
1000022222200001
1000022222200001
1000022222200001
1000022222200001
1000000111000001
1000000000000001
1000000000000001
1000000000000001
1000000000000001
1000000000000001
1000000000000001
1000000000000001
1000000000000001
1000000000000001
1000000000000001
1000000000000001
1000000N00000001
1111111111111111
