R 900 700
       
NO textures/greystone.xpm
SO textures/eagle.xpm
WE textures/purplestone.xpm
EA textures/wood.xpm
S textures/greenlight.xpm

C 34,56,200
F 0,0,0

      
      
1111111111111111
1000000000000001
1000022222200011
1000000000000011
1000022222200001
1000022222200001
1000022222200001
1000022222200001
1000000111000001
1000000000000011
1000000000E00111
1000000200000001
1000000000000001
1000000000000001
1111110000000001
1000000000000001
1000002220000001
1000000000000001
1000000000000001
1000002000000001
1000000000000001
1000000000000001
1000000000000011
1111111111111111